1111111111111111111
1Q000000010000000Q1
1011011101011101101
1000000000000000001
1011010111110101101
1000010001000100001
1111011101011101111
1111010000000101111
111101011X110101111
A0000001AEA1000000A
1111010111110101111
100001000P000100001
1011011101011101101
1001010001000101001
1101010111110101011
1000000001000000001
1011011101011101101
1Q000000000000000Q1
1111111111111111111